############
#----------#
#-#######--#
#-#-----D--#
#-#######--#
#-D-----D--#
#-#-#-#-#-##
#----------#
#----------#
#----------#
#----------#
############