#######
###-###
#-----#
###-###
#######
