############
#----------#
#---#------#
#--------#-#
#----------#
#--#-------#
#----------#
#----#-----#
#----------#
#-------#--#
#----------#
############